00000000110000001100000000
00000000110000001100000000
00333333110000000000000000
00333333110000000000111111
11333333000000000000000000
11333333000000000000000000
33333333000000004444000000
33333333000000004444000000
00333300000000444444000000
00000000000011111100002222
00000000000011111100002222
00000000000000000000000000
00000000000000000000000000
44443333000000000033334444
44443333000000000033334444
11111111111111111111111111
11111111111111111111111111
33333333333333333333333333
33333333333333333333333333
00000000444400000000000000
00000000444400000000111111
33333300000000001111111111
33330000000000000011111111
00000000000111100000000000
11000000000100100033333333
00000000000100100000000000